wwwwwwwwwwwww
wwA+g....w..w
wwww........w
w...w...w..ww
www.w2..wwwww
w.......w...w
w.2.........w
w.....2.....w
wwwwwwwwwwwww